alias ll='ls -la'
alias l='ls -al'
alias cl='clear'
alias md='mkdir'

### VirtualEnv
alias act='. bin/activate'
alias deact='deactivate'

### Git alias command

alias pull='git pull'
alias push='git push'
alias st='git status'
alias commit='git commit -m'
alias add='echo "Branch -> `git rev-parse --abbrev-ref HEAD`" && git add'
alias remote='git remote'
alias diff='git diff'
alias clone='git clone'
alias status='git status'
alias checkout='git checkout'
alias branch='git branch'
alias merge='git merge'
alias log='git log'
alias config='git config'
alias fetch='git fetch'
alias init='git init'
alias show='git show'
alias amend='git commit --amend'
alias submodule='git submodule add'
alias tag='git tag'
alias reset='git reset'
alias rebase='git rebase'
